"filename", "language", "Java", "Groovy", "Java Properties", "Batch", "Markdown", "comment", "blank", "total"
"/Users/armstrong/Documents/code/java/astrolabe/README.md", "Markdown", 0, 0, 0, 0, 2, 0, 0, 2
"/Users/armstrong/Documents/code/java/astrolabe/build.gradle", "Groovy", 0, 32, 0, 0, 0, 1, 5, 38
"/Users/armstrong/Documents/code/java/astrolabe/gradle/wrapper/gradle-wrapper.properties", "Java Properties", 0, 0, 7, 0, 0, 0, 1, 8
"/Users/armstrong/Documents/code/java/astrolabe/gradlew.bat", "Batch", 0, 0, 0, 41, 0, 30, 22, 93
"/Users/armstrong/Documents/code/java/astrolabe/settings.gradle", "Groovy", 0, 6, 0, 0, 0, 0, 0, 6
"/Users/armstrong/Documents/code/java/astrolabe/src/main/java/astrolabe/AngleDistanceRamsete.java", "Java", 69, 0, 0, 0, 0, 0, 21, 90
"/Users/armstrong/Documents/code/java/astrolabe/src/main/java/astrolabe/AstrolabeLogger.java", "Java", 7, 0, 0, 0, 0, 0, 4, 11
"/Users/armstrong/Documents/code/java/astrolabe/src/main/java/astrolabe/AstrolabePath.java", "Java", 17, 0, 0, 0, 0, 0, 4, 21
"/Users/armstrong/Documents/code/java/astrolabe/src/main/java/astrolabe/AutoBuilder.java", "Java", 76, 0, 0, 0, 0, 0, 11, 87
"/Users/armstrong/Documents/code/java/astrolabe/src/main/java/astrolabe/DriveToAngle.java", "Java", 42, 0, 0, 0, 0, 0, 6, 48
"/Users/armstrong/Documents/code/java/astrolabe/src/main/java/astrolabe/DriveToDistance.java", "Java", 43, 0, 0, 0, 0, 0, 6, 49
"/Users/armstrong/Documents/code/java/astrolabe/src/main/java/astrolabe/FollowPath.java", "Java", 41, 0, 0, 0, 0, 0, 12, 53
"/Users/armstrong/Documents/code/java/astrolabe/src/main/java/astrolabe/GlobalConfig.java", "Java", 28, 0, 0, 0, 0, 0, 6, 34
"/Users/armstrong/Documents/code/java/astrolabe/src/main/java/astrolabe/PathParser.java", "Java", 59, 0, 0, 0, 0, 0, 14, 73
"/Users/armstrong/Documents/code/java/astrolabe/src/main/java/astrolabe/Ramsete.java", "Java", 53, 0, 0, 0, 0, 0, 13, 66
"/Users/armstrong/Documents/code/java/astrolabe/src/main/java/astrolabe/Refine.java", "Java", 40, 0, 0, 0, 0, 0, 7, 47
"Total", "-", 475, 38, 7, 41, 2, 31, 132, 726